Main Development:
Green_Jab

Major Dev Contributions:
Mapbook - Nettakrim
Terrain - Quidivo
Enchanting System Setup - Laazuli
Textures - Eleanor

Other Dev Contributers:
KikuGie
Trigam

Code from other Mods Used:
Stamina Rendering - Apple Skin - Squeek502
Chiseled Bookshelf Rendering - Better Bookshelves - Bawnorton
Green Glint Rendering - Enchant The Rainbow - Pepperoni-Jabroni
Villager Armour Rendering - Villager Armor Layer - Viola-Siemens

Other Credits:
Dragon Fight Boss Music - Resonant Tonality
Vanilla Tweaks Resource Packs
Friend and Ideas Discussions: Bricky

Language:
Russian: oleniz
German: dj_creeper_174
Norwegian (bokmål/nynorsk): bloodaxe
French: divach
Hebrew: gaming_everyday
Ukraine: Eevan99
Polish: Merzouuu
Czech: Dadamalda (Also UK English and Anglish)
Italian: Giulmort27
Brazilian Portuguese: richaell
Traditional Chinese: skps2010 蘆筍

